    private int[] posicionX={270,360,450,540,630,720,810,900,990,1080,1170,1260,1350,1440,1530,1620,1710,
                            90,1620,1710,
                            90,180,270,360,450,540,720,810,900,990,1080,1170,1260,1350,1440,
                            180,540,720,1440,1620,
                            0,180,360,720,900,990,1170,1260,1440,1530,1620,
                            180,360,450,540,720,990,1170,1260,1440,
                            90,180,270,360,450,540,720,990,1170,1260,1440,1530,1710,
                            90,450,540,720,810,900,990,1170,1260,1440,1530,
                            90,180,270,450,540,720,810,900,990,1170,1260,1440,1530,1620,
                            270,1260,1620,
                            90,180,270,360,450,540,630,720,810,900,990,1080,1170,1260,1350,1440,1530,1620,1710
                            };
    private int[] posicionY={0,0,0,0,0,0,0,0,0,0,0,0,0,0,0,0,0,
                            90,90,90,
                            180,180,180,180,180,180,180,180,180,180,180,180,180,180,180,
                            270,270,270,270,270,
                            360,360,360,360,360,360,360,360,360,360,360,
                            450,450,450,450,450,450,450,450,450,
                            540,540,540,540,540,540,540,540,540,540,540,540,540,
                            630,630,630,630,630,630,630,630,630,630,630,
                            720,720,720,720,720,720,720,720,720,720,720,720,720,720,
                            810,810,810,
                            900,900,900,900,900,900,900,900,900,900,900,900,900,900,900,900,900,900,900
                            };
